10|5|20|1|
1|1|1|1|1|
1|0|1|3|1|
1|1|3|1|1|
1|1|1|1|1|
1|1|1|1|1|
1|1|1|1|1|
1|1|1|3|1|
1|1|3|1|1|
1|1|1|1|1|
1|1|1|5|1|
