11|11|20|1|
0|5|1|1|1|1|1|1|1|1|5|
18|18|18|18|18|18|18|18|18|18|18|
1|3|3|1|1|18|1|1|3|1|1|
1|3|1|1|1|18|1|1|1|1|1|
1|1|1|1|1|18|1|1|3|1|1|
18|18|18|18|18|18|18|18|18|18|18|
1|1|1|1|1|18|1|1|1|1|1|
1|3|3|1|1|18|1|3|3|1|1|
1|1|3|1|1|18|1|3|3|1|1|
1|1|1|1|1|18|1|1|1|1|1|
1|1|1|1|1|18|1|1|1|1|1|